.......................#.........#.....#...#.............#.
.#.#.#.#...#.#....###...###..#.#.###.#...#.#.##..###.##..#.
.......#.#...#.#.....#.....#.#.#.....#.................#.#.
.#.#..##.#.#..##.#.##.#.##.....#####..####...#####.#.#.#.#.
.......#.#...#...#.......#...#.#.....#.......#.........#...
.#.#####.###.#.##..#...#.##..#.##.##.#.###.#.#.#.#.#.#.##..
.#.#.....#...#.......#.#.#...#.......#.....#.........#...#.
.##...###..#.#.#.#.##....#.#...#.#.###.#.#.#...#.#.#..##.#.
...#.......#...#.#...#.....#...#.#.....#.#...#.#...#...#.#.
...#.#.##..#.#.#.##..#.#..####.#.###.#.#.#.#...#.#.....#.#.
.....#...#...#...#...#.#.#.....#...#.#.......#.#.........#.
..#.###..#.#.#..#..###.#.#.#####.##........###.#..##.###...
.#...............#.#.#.#.#...............#.#.....#.......#.
.#.#.##.##.#.#.##..#.#.#####.#####.#.#.#.#...#.#...##.##.##
.....#.............#.#.....#.....#.#.#.#...#.#...#.#.......
##.##.##...###.#####.#.#.#..####.#..##..##.#.###.###.#.#.#.
...................#.....#.............#...#.........#...#.
..####...#...##..#.#.###############.##..#.###.###.##..#.#.
.............#...#.....#...........#.....#...#.......#.....
.#..###.##.#.###.#...#.#.##..#.###.####.####.#.#####.#.###.
...#...#...#.....#.......................#.......#.#.#.....
.#...#.#.##..#.....#####.#.##..#.###.#.###.##.##...#...###.
...#.#.#.....#.#.#...#...#.#.#.#...........#...#.......#.#.
.#...#.#####.....###..##.#.#...###.#..##...#.#..###.#..#.#.
...................#.....#.#.......#...#...............#...
.#########.#####.##....###.#...###.#.#.....####.####.###.#.
...........#.....#.......#.#.#...#.....#.#.............#...
..##.#.####..#...#.#####.#.#.##..#.#.##..##..#.#.#..##.#..#
.....#.....#.#...#.#.....#.#...#...#.........#.#.....#.#...
..##.#.##..###........#..#.#...###.#.#..#......#.#.#....#..
.......#.......#.#.............#.#.......#.#...#.........#.
.#..##.#.#.#.##..#.....##.###....#.###.###.#######.#.#.###.
.#.#.....#...................#.#...........#.....#.....#...
.#.#.##.##.#####.##.#.....#....#..#....#.##..#.###...#.#.#.
...#.......#...#.............#.#.......#.....#.....#.......
..##...#.###.#.#.##..#..###....###.##..#..##..####...#.###.
.....#...........#.#.........#...#.............#...#.......
.#####.#####.#.#.#...#.#...####..#.#.###.##.##.#.#.#.#.#.#.
.#.....#...#.....#...#.#...#.......#...#.....#...#.#.#...#.
.#.#.###.#..#..###.##....###.#####.#.#.#####...###.##..#...
...#...........#.........#...#.......#.......#...#.........
.######.###..###.#.#####.#.#.#.#.#.#..##.....#.#.#...####..
.....#...............#...#.#.#.........#.#.#.......#.......
.#.#.#.#####..##....##..#.....####..##.#.#..##.#.#.#.#.####
...#.#.......#...#.........#.........#.........#.#...#.....
.#.#.#.##..#.....#.###.###.....###.#.##..#.#####...#.##..#.
.#.#...#...#...#...#...#.#.....#.........#.#...#.......#...
...#####.####..#.#.#...#.##..#.#.#####.###.#.#.####.##.#.##
.#.....#.........#.#.#.#.......#...#.#.#...#.#.............
..####.###..###..#.#.#.#.#.##.####.#.#.#...#..#####.######.
...#...#.............#...#...#...........#.#.......#.......
.#.#.#.#.#...#.###.#.#.#.#.#...#.##....#..######...#.##....
.#.#...#.#.....#...#...#.#...............#.......#...#.....
.#.#.#.....##.###..#.#.#.#.......##..##.#..#####.#.#...#...
.#.......#...........#.#.......#.....#.....#.......#...#...
...#.####..#....##.##..##.###..#.#.#.#.#####....###..##..#.
.#.#.#...#...#.............#.....#.#.#...#...#.#...#.....#.
....#..#.###.###.....#.###.##.##.#.#...#.#...###...####..#.
.......#.................#.......#.......#.#...............
