...#...#.#.#..##.#..
#....#......#......#
#.#....###..#...#.#.
#.#......##...#.....
.....#.#..####.#..#.
#.#.#......#.......#
#...#.#.#....##.#...
..#...#.#...#....#..
....#....#..#....#.#
....##..#.....####..
#.#.#....##...#.....
..#...#.#...#....#..
....#.......#...#...
.##.###.###.#....#.#
.....#...#.......#..
.#.#...#.#.#...#...#
...##........##...#.
.#..##..#.....##.#..
..#..#....#..#.#..#.
#.#......##.........